аборт		борт	
авария	negative	вария	
аврал		врал	
ад	negative	д	
аномалия		омалия	
анус		ус	
безбедность		бедность	
безвкусность		вкусность	positive
безвольность	negative	вольность	
безвременность		временность	
безгрешность	positive	грешность	
бездействие		действие	
бездеятельность		деятельность	
бездоказательность	negative	доказательность	
безжалостность	negative	жалостность	
безжизненность		жизненность	
беззаконность	negative	законность	
безмозглость	negative	мозглость	
безмятежность		мятежность	
безнравственность	negative	нравственность	
безоблачность		облачность	
безобразность	negative	образность	
безопасность		опасность	negative
безосновательность	negative	основательность	
безответственность	negative	ответственность	
безотрадность	negative	отрадность	
безразличие		различие	
безразличность		различность	
безумность	negative	умность	
безыскусность		искусность	positive
беспорядок	negative	порядок	
беспочвенность		почвенность	
беспредел	negative	предел	
беспутник	negative	путник	
беспутница	negative	путница	
бестолочь	negative	толочь	
гиперинфляция		инфляция	
гипертоник		тоник	
дебош	negative	бош	
дегенерация	negative	генерация	
деградация	negative	градация	
дедуля		дуля	
деза	negative	а	
дезинформация	negative	информация	
дезинформирование	negative	информирование	
дезорганизатор	negative	организатор	
дезорганизация	negative	организация	
деморализация		морализация	
десинхрония	negative	синхрония	
деспот	negative	спот	
деформация		формация	
деформирование		формирование	
дисбаланс		баланс	
дистрофик		трофик	
иллюзия		люзия	
ирод		од	
контрзаговор		заговор	negative
контрпродуктивность	negative	продуктивность	
лжебанкрот		банкрот	negative
неадекват	negative	адекват	
неактуальность		актуальность	
небанальность		банальность	
небезопасность	negative	безопасность	
небезосновательность		безосновательность	negative
небезразличие	positive	безразличие	
небезупречность		безупречность	positive
небесталанность		бесталанность	negative
неважность		важность	
невежа	negative	вежа	
невежда	negative	вежда	
неверность	negative	верность	
невиновность		виновность	negative
невменяемость		вменяемость	positive
невнимание		внимание	
невозврат		возврат	
невозможность		возможность	
невостребованность		востребованность	positive
невыход		выход	
нега	positive	га	
негодность	negative	годность	
недалекость	negative	далекость	
недержание		держание	
недобор		добор	
недоброкачественность	negative	доброкачественность	
недоверие	negative	доверие	
недоверчивость	negative	доверчивость	
недовольство	negative	довольство	
недогляд		догляд	
недоделка		доделка	
недооценка		дооценка	
недоработка		доработка	
недосмотр	negative	досмотр	
недостаток		достаток	
недосягаемость	negative	досягаемость	
незадача		задача	
незаконность	negative	законность	
незаслуженность	negative	заслуженность	
нездоровье	negative	здоровье	
неизлечимость	negative	излечимость	
некоммуникабельность		коммуникабельность	positive
некомпетентность	negative	компетентность	
неконституционность	negative	конституционность	
нелады	negative	лады	
неловкость		ловкость	
нелюбовь		любовь	positive
нелюди	negative	люди	
ненатуральность		натуральность	positive
необразованность	negative	образованность	
неопытность		опытность	positive
неосторожность	negative	осторожность	
неохота	negative	охота	
неплательщица	negative	плательщица	
неповиновение	negative	повиновение	
неподдельность		поддельность	
непозволительность	negative	позволительность	
непорядок	negative	порядок	
непоследовательность		последовательность	
непотребность	negative	потребность	
неправда	negative	правда	
неправомерность	negative	правомерность	
непредубежденность	positive	предубежденность	
непреклонность		преклонность	
непритворность		притворность	negative
неприхотливость		прихотливость	
неприязненность	negative	приязненность	
непродуктивность	negative	продуктивность	
непродуманность		продуманность	
непроизводительность	negative	производительность	
непростительность	negative	простительность	
неравнодушие	positive	равнодушие	
нерасположение		расположение	
нерациональность		рациональность	
несвобода	negative	свобода	
несмелость		смелость	positive
несносность	negative	сносность	
несовершенность		совершенность	positive
несовершенство		совершенство	positive
неспособность		способность	
несчастие	negative	счастие	
неталантливость		талантливость	positive
нетерпимость	negative	терпимость	
неувязка		увязка	
неудовлетворительность	negative	удовлетворительность	
неумение	negative	умение	
неуместность	negative	уместность	
неуравновешенность	negative	уравновешенность	
неуспеваемость		успеваемость	
неутешительность	negative	утешительность	
неучтивость	negative	учтивость	
нефиг	negative	фиг	
нефига	negative	фига	
нехрен	negative	хрен	
нецензурность	negative	цензурность	
нечисть	negative	чисть	
нечуткость		чуткость	positive
превознесение		вознесение	
превозношение		возношение	
преданность		данность	
предатель	negative	датель	
презрение	negative	зрение	
преимущество	positive	имущество	
преисподняя		исподняя	
прелесть	positive	лесть	
премудрость		мудрость	positive
преследование		следование	
преследовательница		следовательница	
преуспевание	positive	успевание	
псевдонаука		наука	
суперкласс		класс	
алейкемия		лейкемия	
аморалист	negative	моралист	
аморфизм		морфизм	
анастигматизм		астигматизм	
ангидрид		гидрид	
антиатом		атом	
антивещество		вещество	
антивибратор		вибратор	
антивирус		вирус	negative
антиводород		водород	
антивыставка		выставка	
антигалактика		галактика	
антигелий		гелий	
антиген		ген	
антигерой	negative	герой	positive
антиглобализация		глобализация	
антидактиль		дактиль	
антидейтрон		дейтрон	
антидот		дот	
антизакон	negative	закон	
антикатализатор		катализатор	
антикатод		катод	
антикафе		кафе	
антикварк		кварк	
антиклимакс		климакс	
антикоагулянт		коагулянт	
антикрыло		крыло	
антилидер	negative	лидер	positive
антилогарифм		логарифм	
антиматерия		материя	
антимир		мир	
антимоль		моль	
антимораль	negative	мораль	
антинаграда	negative	награда	positive
антинейтрино		нейтрино	
антинейтрон		нейтрон	
антиокислитель		окислитель	
антипапа		папа	
антипараллелограмм		параллелограмм	
антипасха		пасха	
антипатриотизм	negative	патриотизм	
антипатриотичность	negative	патриотичность	
антипедагог	negative	педагог	
антиперистальтика		перистальтика	
антиподера		подера	
антиправо	negative	право	
антипремия	negative	премия	positive
антипризма		призма	
антипротон		протон	
антиракета		ракета	
антирастворитель		растворитель	
антирейтинг	negative	рейтинг	
антиреклама	negative	реклама	
антирекорд	negative	рекорд	positive
антирекордсмен	negative	рекордсмен	positive
антисептик		септик	
антисептика		септика	
антисервис	negative	сервис	
антисистема	negative	система	
антисканер		сканер	
антисминание		сминание	
антиспам		спам	negative
антистатик		статик	
антистатичность		статичность	
антистрофа		строфа	
антисыворотка		сыворотка	
антитеза		теза	
антитело		тело	
антитерроризм		терроризм	negative
антитоксин		токсин	
антифаза		фаза	
антифашизм		фашизм	negative
антифашист		фашист	negative
антифашистка		фашистка	negative
антифермент		фермент	
антифриз		фриз	
антифутбол		футбол	
антихлор		хлор	
антицепь		цепь	
антициклон		циклон	
античастица		частица	
антиэлектрон		электрон	
антиядро		ядро	
архидиаконство		диаконство	
архидьякон		дьякон	
архидьяконство		дьяконство	
архиепископ		епископ	
архиерей		ерей	
архипастырь		пастырь	
архисема		сема	
архисинагог		синагог	
архифонема		фонема	
асексуальность		сексуальность	positive
асемантема		семантема	
астигмат		стигмат	
астигматизм		стигматизм	
атональность		тональность	
афагия		фагия	
ахромат		хромат	
ахроматизм		хроматизм	
ахроматин		хроматин	
безбожница		божница	
безвиз		виз	
безводица		водица	
безводность		водность	
безвыгодность	negative	выгодность	positive
безгражданство		гражданство	
бездомник		домник	
бездонье		донье	
бездымка		дымка	
беззаконник	negative	законник	
беззаконница	negative	законница	
безлимит		лимит	
безличность		личность	
безлошадник		лошадник	
безнадёжность	negative	надёжность	positive
безнадёжность		надёжность	
безналичка		наличка	
безналичник		наличник	
безнационализм		национализм	
безотвалка		отвалка	
безоткатка		откатка	
безрыбица		рыбица	
безусловность		условность	
безъядерность		ядерность	
безъязыкость		языкость	
безъязычие		язычие	
безыгровой		игровой	
безымянка		имянка	
безынерционность		инерционность	
безынтересность	negative	интересность	positive
бесконечность		конечность	
бескорневой		корневой	
бескрайность		крайность	
бескровность		кровность	
беспартийность		партийность	
бесписьменность		письменность	
беспоповщина		поповщина	
бесприбыльность	negative	прибыльность	positive
бессеменной		семенной	
бессемянка		семянка	
бессмертник		смертник	
бессребреник		сребреник	
бесхарактерность	negative	характерность	
бесхозяйственность		хозяйственность	
бесцарствие		царствие	
бесчувствие		чувствие	
гиперавторство		авторство	
гипергликемия		гликемия	
гипердержава		держава	
гиперзвук		звук	
гиперкинез		кинез	
гиперкомпенсация		компенсация	
гиперкорректность		корректность	
гиперкоррекция		коррекция	
гипермаркет		маркет	
гиперопека		опека	
гиперплоскость		плоскость	
гиперпространство		пространство	
гипертекст		текст	
гипертонус		тонус	
гипершар		шар	
гиперядро		ядро	
деавтоматизация		автоматизация	
деадвербиализация		адвербиализация	
деадъектив		адъектив	
деактивация		активация	
деаэратор		аэратор	
деаэрация		аэрация	
деблокада		блокада	
деблокирование		блокирование	
девальвация		вальвация	
девозбуждение		возбуждение	
дегазация		газация	
дегидратация		гидратация	
дегидрирование		гидрирование	
дегидрогенизация		гидрогенизация	
дезагрегирование		агрегирование	
дезадаптация		адаптация	
дезактивация		активация	
дезалкоголизация		алкоголизация	
дезинвагинация		инвагинация	
дезинтегратор		интегратор	
дезинтеграция		интеграция	
дезинтоксикация		интоксикация	
дезинфектор		инфектор	
дезинфекция		инфекция	
дезинфицирование		инфицирование	
дезинфляция		инфляция	
дезодоратор		одоратор	
дезориентация		ориентация	
дезориентировка		ориентировка	
дезурбанизация		урбанизация	
дезурбанизм		урбанизм	
деиндивидуализация		индивидуализация	
деиндустриализация		индустриализация	
деионизация		ионизация	
декальцинация		кальцинация	
деквалификация		квалификация	
декодер		кодер	
декодирование		кодирование	
деколлаж		коллаж	
деколлективизация		коллективизация	
деколонизация		колонизация	
декомпенсация		компенсация	
декомпозиция		композиция	
декомпрессия		компрессия	
декомпрессор		компрессор	
декриминализация		криминализация	negative
делабиализация		лабиализация	
делимитация		лимитация	
демаркетинг		маркетинг	
демаскирование		маскирование	
демаскировка		маскировка	
дематериализация		материализация	
деминерализация		минерализация	
демифологизация		мифологизация	
демонтаж		монтаж	
демультиплексирование		мультиплексирование	
демультипликатор		мультипликатор	
демуниципализация		муниципализация	
денатурализация		натурализация	
денационализация		национализация	
денитрификация		нитрификация	
деноминатив		номинатив	
деноминация		номинация	
деоккупация		оккупация	
депигментация		пигментация	
депозиция		позиция	
деполимеризация		полимеризация	
деполяризатор		поляризатор	
деполяризация		поляризация	
депопуляция		популяция	
депоэтизация		поэтизация	
депролетаризация		пролетаризация	
депрофессионализация		профессионализация	
дереализация		реализация	
десакрализация		сакрализация	
десегрегация		сегрегация	
десенсибилизатор		сенсибилизатор	
десенсибилизация		сенсибилизация	
десорбция		сорбция	
десублимация		сублимация	
дефенестрация		фенестрация	
дефолиант		фолиант	
дефолиация		фолиация	
дехлорирование		хлорирование	
децентрализация		централизация	
дешифратор		шифратор	
дешифровка		шифровка	
деэмульгатор		эмульгатор	
деэмульгирование		эмульгирование	
деэскалация		эскалация	
деэтимологизация		этимологизация	
дизонтогенез		онтогенез	
дисгармония	negative	гармония	positive
дисгармония		гармония	
дисквалификация	negative	квалификация	
дисконтактность		контактность	
диспаритет		паритет	
диспаритетность		паритетность	
диссимуляция		симуляция	
дисфункция		функция	
имматериализм		материализм	
иммигрант		мигрант	
иммиграция		миграция	
имперфект		перфект	
имплантация		плантация	
импорт		порт	
инвариантность		вариантность	
индетерминист		детерминист	
иннервация		нервация	
инноватор		новатор	
инновация		новация	
интоксикация		токсикация	
интолерантность	negative	толерантность	
интонирование		тонирование	
инфильтрат		фильтрат	
инфильтрация		фильтрация	
иррадиация		радиация	
контратака		атака	
контрвыпад		выпад	
контржалоба		жалоба	
контригра		игра	
контркультура		культура	
контрманёвр		манёвр	
контрмера		мера	
контрмина		мина	
контрминоносец		миноносец	
контрнаступление		наступление	
контрпар		пар	
контрпиар		пиар	
контрпозиция		позиция	
контрпредложение		предложение	
контрпривод		привод	
контрразведка		разведка	
контрразведчик		разведчик	
контрразведчица		разведчица	
контррегулятор		регулятор	
контррельеф		рельеф	
контррельс		рельс	
контрреформа		реформа	
контртенденция		тенденция	
контругроза		угроза	
контрудар		удар	
контршансы		шансы	
контръярус		ярус	
контрэскарп		эскарп	
неактёр		актёр	
неблагозвучие	negative	благозвучие	positive
неблагообразие	negative	благообразие	positive
небыдло		быдло	negative
невесомость		весомость	
невыборка		выборка	
невязка		вязка	
негабарит		габарит	
негерой	negative	герой	
недвижимость		движимость	
неделикатность	negative	деликатность	
недоброжелательство	negative	доброжелательство	positive
недоброхотство	negative	доброхотство	positive
недогрузка		догрузка	
недодача		додача	
недоля		доля	
недомол		домол	
недоплата		доплата	
недоставка		доставка	
недостройщик		достройщик	
недосылка		досылка	
неидеальность		идеальность	positive
неинтеллигентность	negative	интеллигентность	positive
неклен		клен	
неконкурентоспособность	negative	конкурентоспособность	positive
неконфликтность		конфликтность	negative
некто		кто	
нелюбимец	negative	любимец	positive
немедик		медик	
неметалл		металл	
немосквич		москвич	
немузыка		музыка	
немусульманин		мусульманин	
ненадёжность	negative	надёжность	positive
ненасилие		насилие	negative
неписатель		писатель	
неплатёж		платёж	
неплательщик	negative	плательщик	
неплодородность	negative	плодородность	positive
неповторяемость		повторяемость	
непогода		погода	
неподача		подача	
неподвижность		подвижность	
неподдержка		поддержка	positive
неподключение		подключение	
неполегаемость		полегаемость	
неполнота		полнота	
непосредственность		посредственность	negative
непоставка		поставка	
непоэзия		поэзия	
неправдоподобие		правдоподобие	
неправота		правота	
непрекословие		прекословие	
непрерывность		прерывность	
неприбытие		прибытие	
неприводимость		приводимость	
непривычка		привычка	
неприкосновенность		прикосновенность	
неприличье	negative	приличье	positive
непринуждённость		принуждённость	
непринятие		принятие	
неприсоединение		присоединение	
непричастность		причастность	
неприятие	negative	приятие	
непроведение		проведение	
непроводимость		проводимость	
непроводник		проводник	
непроницаемость		проницаемость	
непропуск		пропуск	
непротивление		противление	
непрофессионал		профессионал	
непунктуальность	negative	пунктуальность	
неравенство		равенство	
неравновесие		равновесие	
нерадение	negative	радение	
неразрывность		разрывность	
нерегистрация		регистрация	
неровность		ровность	
нерусь		русь	
неслух		слух	
несовершеннолетие		совершеннолетие	
неспециалист		специалист	
несработанность	negative	сработанность	positive
нестандарт		стандарт	
нестроевик		строевик	
нестыковка		стыковка	
нестяжание		стяжание	
несудимость		судимость	
нетолерантность	negative	толерантность	
нетрадиционалист		традиционалист	
неувеличение		увеличение	
неувядание		увядание	
неуд		уд	
неудобопонятность	negative	удобопонятность	positive
неудовлетворённость	negative	удовлетворённость	positive
неулыба		улыба	
неупоминание		упоминание	
неурожай	negative	урожай	
неустройство		устройство	
неучёт		учёт	
неучтивец	negative	учтивец	positive
неформат		формат	
нехватка		хватка	
нехристь		христь	
нехрущ		хрущ	
нечерноземье		черноземье	
нечерноземье		черноземье	
нечет		чет	
нечистота	negative	чистота	positive
нечлен		член	
неэстонец		эстонец	
преизбыток		избыток	
преклир		клир	
премножество		множество	
преобладание		обладание	
преобразование		образование	
преодоление		одоление	
преподнесение		поднесение	
преподношение		подношение	
препозиция		позиция	
препоручение		поручение	
препровождение		провождение	
пресечение		сечение	
префикс		фикс	
сверхбаллон		баллон	
сверхгалактика		галактика	
сверхгигант		гигант	
сверхгород		город	
сверхгруппа		группа	
сверхдержава		держава	
сверхзадача		задача	
сверхзаработок		заработок	
сверхзвезда		звезда	
сверхзвук		звук	
сверхкомплект		комплект	
сверхкомпьютер		компьютер	
сверхлитература		литература	
сверхмарафон		марафон	
сверхмарафонец		марафонец	
сверхминистерство		министерство	
сверхмодник		модник	
сверхмолния		молния	
сверхнагрузка		нагрузка	
сверхновинка		новинка	
сверхнорматив		норматив	
сверхоперативность	very positive	оперативность	positive
сверхоружие		оружие	
сверхпотребление		потребление	
сверхпроводник		проводник	
сверхпрограмма		программа	
сверхработа		работа	
сверхразум		разум	
сверхсекретность		секретность	
сверхсема		сема	
сверхскорость		скорость	
сверхтяжеловес		тяжеловес	
сверхубийство	very negative	убийство	negative
сверхусилие		усилие	
сверхфантазия		фантазия	
сверхценность	very positive	ценность	positive
сверхчеловек		человек	
суперантибиотик		антибиотик	
суперарбитр		арбитр	
супербактерия		бактерия	
суперблок		блок	
супервулкан		вулкан	
супергазопровод		газопровод	
супергероиня		героиня	
супергерой		герой	
супергетеродин		гетеродин	
супергигант		гигант	
супергитарист		гитарист	
супергород		город	
супергроссмейстер		гроссмейстер	
супергруппа		группа	
суперделегат		делегат	
супердержава		держава	
супердискотека		дискотека	
суперженщина		женщина	
суперзлодей		злодей	negative
суперзлодейка		злодейка	negative
суперидея		идея	
суперинфекция		инфекция	
суперкарго		карго	
суперклуб		клуб	
суперкоманда		команда	
суперкомпьютер		компьютер	
суперконцерн		концерн	
суперкубок		кубок	
суперлайнер		лайнер	
суперлинза		линза	
супермарафон		марафон	
супермаркет		маркет	
супермаховик		маховик	
супермашина		машина	
супермодель		модель	
супермонополия		монополия	
супернебоскрёб		небоскрёб	
суперобложка		обложка	
суперпоезд		поезд	
суперпозиция		позиция	
суперпользователь		пользователь	
суперприбор		прибор	
суперпрограмма		программа	
суперпроект	positive	проект	
суперпространство		пространство	
суперпроцесс		процесс	
суперсервер		сервер	
суперсила		сила	
суперсимметрия		симметрия	
суперскаляр		скаляр	
суперспособность		способность	
суперстанция		станция	
суперструктура		структура	
суперструна		струна	
суперсудно		судно	
супертайфун		тайфун	
супертанкер		танкер	
супертелевизор		телевизор	
супертраулер		траулер	
супертурнир		турнир	
супертяжеловес		тяжеловес	
суперфинал		финал	
суперфиниш		финиш	
суперфосфат		фосфат	
суперцена		цена	
суперцентрализация		централизация	
суперцивилизация		цивилизация	
супершоу		шоу	
суперъястреб		ястреб	
суперэвм		эвм	
суперэлита		элита	
абсурд	negative		
абсурдность	negative		
аварийность	negative		
авиакрушение	negative		
авианалет	negative		
автовор	negative		
автоподстава	negative		
авторитаризм	negative		
авторитарность	negative		
автоугон	negative		
автоугонщик	negative		
агрессивность	negative		
агрессия	negative		
агрессор	negative		
алкаш	negative		
алкашка	negative		
алкоголичка	negative		
алконавт	negative		
алогичность	negative		
алчность	negative		
аморальность	negative		
ангажированность	negative		
антигуманность	negative		
антисанитария	negative		
антисемит	negative		
антисемитизм	negative		
антисемитка	negative		
антропофагия	negative		
апартеид	negative		
арест	negative		
аутсайдер	negative		
афера	negative		
аферист	negative		
аферистка	negative		
ахинея	negative		
балабол	negative		
балаболка	negative		
балаган	negative		
балбес	negative		
балбеска	negative		
балда	negative		
бандгруппа	negative		
бандгруппировка	negative		
бандит	negative		
бандитизм	negative		
бандитка	negative		
бандподполье	negative		
бандюга	negative		
бандюган	negative		
банкротство	negative		
бардак	negative		
барсеточник	negative		
барыга	negative		
басмачество	negative		
бахвал	negative		
бахвалка	negative		
башибузук	negative		
беда	negative		
бедлам	negative		
бедствие	negative		
безалаберность	negative		
безбилетник	negative		
безбилетница	negative		
безволие	negative		
безголовость	negative		
безграмотность	negative		
бездарность	negative		
бездарь	negative		
бездельник	negative		
бездельница	negative		
бездумность	negative		
бездушие	negative		
бездушность	negative		
беззаконие	negative		
безнадега	negative		
безнадежность	negative		
безнаказанность	negative		
безобразие	negative		
безобразник	negative		
безобразница	negative		
безрадостность	negative		
безумец	negative		
безумие	negative		
безумство	negative		
безумье	negative		
безуспешность	negative		
безутешность	negative		
безысходность	negative		
белиберда	negative		
бесконтрольность	negative		
бескультурие	negative		
бескультурье	negative		
беспардонность	negative		
бесперспективность	negative		
беспокойство	negative		
бесполезность	negative		
беспорядочность	negative		
беспощадность	negative		
беспринципность	negative		
беспросветность	negative		
беспутность	negative		
беспутство	negative		
бессердечие	negative		
бессердечность	negative		
бессилие	negative		
бессовестность	negative		
бесстыдник	negative		
бесстыдница	negative		
бесстыдность	negative		
бесстыдство	negative		
бестактность	negative		
бестолковость	negative		
бестолковщина	negative		
бесчеловечность	negative		
бесчестность	negative		
бесчестье	negative		
бесчувственность	negative		
блевание	negative		
блевота	negative		
блевотина	negative		
блуд	negative		
блудник	negative		
блудница	negative		
блюдолиз	negative		
блядство	negative		
бодяга	negative		
бойня	negative		
болван	negative		
боль	negative		
бомба	negative		
бомжатник	negative		
бомжиха	negative		
бомжовый	negative		
брань	negative		
братоубийство	negative		
братоубийца	negative		
бред	negative		
бредни	negative		
брехня	negative		
брехун	negative		
брехунья	negative		
бульварность	negative		
бульварщина	negative		
бумаготворчество	negative		
бюрократ	negative		
бюрократия	negative		
бюрократка	negative		
вакханалия	negative		
вандал	negative		
вандализм	negative		
вандалка	negative		
варварство	negative		
вероломность	negative		
вероломство	negative		
вертопрах	negative		
взбучка	negative		
вздор	negative		
вздорность	negative		
взламывание	negative		
взлом	negative		
взрыв	negative		
взятка	negative		
взяткодатель	negative		
взяткодательница	negative		
взяткодательство	negative		
взяточник	negative		
взяточница	negative		
взяточничество	negative		
виновник	negative		
виновница	negative		
виновный	negative		
властолюбец	negative		
властолюбие	negative		
властолюбица	negative		
возмутительность	negative		
возмущение	negative		
волокита	negative		
волокитчик	negative		
волокитчица	negative		
вонь	negative		
вор	negative		
воришка	negative		
воровка	negative		
ворчливость	negative		
ворчун	negative		
ворчунья	negative		
ворье	negative		
ворюга	negative		
враг	negative		
вражда	negative		
враждебность	negative		
враль	negative		
вранье	negative		
вред	negative		
вредитель	negative		
вредительница	negative		
вредительство	negative		
вредность	negative		
вредоносность	negative		
врун	negative		
врунья	negative		
вседозволенность	negative		
встревание	negative		
вторжение	negative		
вульгарность	negative		
выбоина	negative		
выклянчивание	negative		
выкрадывание	negative		
вымирание	negative		
вымогание	negative		
вымогатель	negative		
вымогательница	negative		
вымогательство	negative		
выпендреж	negative		
выпендривание	negative		
выпивоха	negative		
выскочка	negative		
высокомерие	negative		
высокопарность	negative		
вычурность	negative		
гад	negative		
гадливость	negative		
гадостность	negative		
гадость	negative		
галиматья	negative		
гандон	negative		
гибельность	negative		
гитлеризм	negative		
глупец	negative		
глупость	negative		
глухомань	negative		
гнида	negative		
гниение	negative		
гнус	negative		
гнусность	negative		
говнюк	negative		
головорез	negative		
головотяпство	negative		
голодомор	negative		
голодранец	negative		
голодуха	negative		
голословность	negative		
гомофоб	negative		
гопник	negative		
гопота	negative		
гордец	negative		
гордыня	negative		
гордячка	negative		
горесть	negative		
горлопан	negative		
горлопанка	negative		
горлохват	negative		
госизменник	negative		
грабеж	negative		
грабиловка	negative		
грабитель	negative		
грабительница	negative		
грех	negative		
грубиян	negative		
грубиянка	negative		
грызня	negative		
губитель	negative		
губительность	negative		
губошлеп	negative		
гяур	negative		
двуликость	negative		
двуличие	negative		
двуличность	negative		
двурушник	negative		
двурушница	negative		
двурушничество	negative		
дебил	negative		
дебилка	negative		
дебошир	negative		
дебоширка	negative		
дебоширство	negative		
дегенерат	negative		
дезертир	negative		
дезертирство	negative		
дезорганизаторство	negative		
деликт	negative		
демагогичность	negative		
демагогия	negative		
деспотизм	negative		
деспотичность	negative		
деспотия	negative		
деструктивность	negative		
деструкция	negative		
детоубийство	negative		
детоубийца	negative		
дешевка	negative		
диверсант	negative		
диверсантка	negative		
диверсия	negative		
дизентерия	negative		
дикарка	negative		
диктаторство	negative		
диктатура	negative		
дилетантизм	negative		
дилетантство	negative		
дискомфорт	negative		
дискомфортность	negative		
дискредитация	negative		
дискредитирование	negative		
дискриминация	negative		
диссидентство	negative		
договорняк	negative		
докучливость	negative		
докучность	negative		
доморощенность	negative		
домушник	negative		
домушница	negative		
доносчик	negative		
доносчица	negative		
дрязги	negative		
дрянь	negative		
дурак	negative		
дурачье	negative		
дурень	negative		
дуреха	negative		
дурновкусие	negative		
дурость	negative		
дурочка	negative		
дурь	negative		
душегуб	negative		
ебало	negative		
ебучий	negative		
ерничанье	negative		
ерничество	negative		
ехидность	negative		
жадность	negative		
жадюга	negative		
жалкость	negative		
желтушность	negative		
желчность	negative		
женоненавистник	negative		
женоубийство	negative		
женоубийца	negative		
жестокость	negative		
живодер	negative		
живодерка	negative		
жиробас	negative		
жмот	negative		
жопа	negative		
жопка	negative		
жулик	negative		
жульничество	negative		
жупел	negative		
жуткость	negative		
жуть	negative		
заангажированность	negative		
забияка	negative		
заблуждение	negative		
забулдыга	negative		
завистник	negative		
завистница	negative		
завышенность	negative		
загнивание	negative		
заговорщик	negative		
заговорщица	negative		
задавака	negative		
задира	negative		
задолжник	negative		
зазнайка	negative		
зазнайство	negative		
закабаление	negative		
закостенение	negative		
закрепощение	negative		
заложничество	negative		
замор	negative		
замусоривание	negative		
занижение	negative		
заносчивость	negative		
зануда	negative		
занудливость	negative		
занудность	negative		
занудство	negative		
запустение	negative		
запущенность	negative		
засорение	negative		
засранец	negative		
застой	negative		
застойность	negative		
засуживание	negative		
заторможенность	negative		
затруднительность	negative		
заунывность	negative		
заурядность	negative		
захватчик	negative		
зачинщик	negative		
зачинщица	negative		
зверство	negative		
злоба	negative		
злобность	negative		
злобствование	negative		
злобствованье	negative		
зловоние	negative		
зловонность	negative		
зловредность	negative		
злодейство	negative		
злодеяние	negative		
злодеянье	negative		
злокозненность	negative		
злонамеренность	negative		
злопамятность	negative		
злопамятство	negative		
злопыхатель	negative		
злопыхательница	negative		
злопыхательство	negative		
злорадство	negative		
злословие	negative		
злостность	negative		
злость	negative		
злосчастность	negative		
злоумышленница	negative		
злоупотребление	negative		
злыдень	negative		
злыдня	negative		
зомбирование	negative		
зубоскал	negative		
зубоскалка	negative		
зубоскальство	negative		
идиот	negative		
идиотизм	negative		
идиотка	negative		
избалованность	negative		
изверг	negative		
извращенец	negative		
извращение	negative		
извращенка	negative		
издеватель	negative		
издевательница	negative		
издевательство	negative		
издевка	negative		
измена	negative		
изменник	negative		
изменница	negative		
измывательство	negative		
измышление	negative		
изнасилование	negative		
изувер	negative		
изуверка	negative		
изуверство	negative		
изъян	negative		
исламофобия	negative		
истеричка	negative		
истязатель	negative		
истязательница	negative		
кабальность	negative		
кавардак	negative		
каверзность	negative		
казнокрад	negative		
казнокрадка	negative		
казнь	negative		
каннибал	negative		
каннибальство	negative		
кара	negative		
карманник	negative		
карманница	negative		
катавасия	negative		
катастрофа	negative		
катастрофичность	negative		
каюк	negative		
киберугроза	negative		
киллер	negative		
киллерство	negative		
киллерша	negative		
кичливость	negative		
клевета	negative		
клеветник	negative		
клеветница	negative		
клептократия	negative		
клептоман	negative		
клептомания	negative		
клептоманка	negative		
коверканье	negative		
козни	negative		
коллаборационизм	negative		
коллаборационист	negative		
компрометация	negative		
компрометирование	negative		
конокрад	negative		
контрабандистка	negative		
конфликт	negative		
конфронтационность	negative		
конфронтация	negative		
концлагерь	negative		
кончина	negative		
коррумпирование	negative		
коррумпированность	negative		
коррупционер	negative		
коррупционность	negative		
коррупция	negative		
корыстность	negative		
корыстолюбец	negative		
корыстолюбие	negative		
корысть	negative		
кошмар	negative		
кощунство	negative		
кража	negative		
крах	negative		
кретин	negative		
кретинка	negative		
кривляка	negative		
кризисность	negative		
крикун	negative		
крикунья	negative		
криминал	negative		
критикан	negative		
критиканка	negative		
критиканство	negative		
кровожадность	negative		
кровопивец	negative		
кровопийца	negative		
кровоподтек	negative		
кровопролитие	negative		
кровосмесительство	negative		
кровосмешение	negative		
крохобор	negative		
крохоборка	negative		
крушение	negative		
ксенофоб	negative		
ксенофобка	negative		
лабуда	negative		
лажа	negative		
лгун	negative		
лгунья	negative		
лентяй	negative		
лентяйка	negative		
лжец	negative		
лживость	negative		
лизоблюд	negative		
лизоблюдка	negative		
лизоблюдство	negative		
лихач	negative		
лихачество	negative		
лихачка	negative		
лицемер	negative		
лицемерие	negative		
лицемерка	negative		
лицемерность	negative		
лицеприятность	negative		
лоботряс	negative		
лоботряска	negative		
лодырь	negative		
ложность	negative		
ложь	negative		
лохотронщик	negative		
лохушка	negative		
лошара	negative		
лузер	negative		
людоед	negative		
людоедство	negative		
ляп	negative		
мазохизм	negative		
мазохист	negative		
мазохистка	negative		
малограмотность	negative		
малодушие	negative		
малокомпетентность	negative		
малопригодность	negative		
малопристойность	negative		
маньяк	negative		
мародерка	negative		
мародерша	negative		
матерщина	negative		
мафиозность	negative		
махинатор	negative		
махинация	negative		
мегера	negative		
мерзавец	negative		
мерзавка	negative		
мерзопакостность	negative		
мерзостность	negative		
мерзость	negative		
меркантилизм	negative		
меркантильность	negative		
мздоимец	negative		
мздоимица	negative		
мнительность	negative		
мордобой	negative		
мот	negative		
мотовка	negative		
мотовство	negative		
мошенник	negative		
мошенница	negative		
мошенничество	negative		
мразь	negative		
мракобес	negative		
мракобесие	negative		
мудак	negative		
мура	negative		
мухосранск	negative		
мучение	negative		
мученичество	negative		
мучитель	negative		
мучительница	negative		
мучительство	negative		
мытарство	negative		
навет	negative		
наглец	negative		
наглость	negative		
наговор	negative		
надменность	negative		
надоедливость	negative		
надоедность	negative		
надругательство	negative		
надуманность	negative		
наезд	negative		
назойливость	negative		
наигранность	negative		
налетчик	negative		
налетчица	negative		
нападки	negative		
напраслина	negative		
напряженка	negative		
напряженность	negative		
напыщенность	negative		
нарик	negative		
наркобанда	negative		
наркобандит	negative		
наркобарыга	negative		
наркобизнесмен	negative		
наркогруппа	negative		
наркогруппировка	negative		
наркодеятельность	negative		
наркодилер	negative		
наркодилерша	negative		
наркодурман	negative		
наркозелье	negative		
наркоинтервенция	negative		
наркоклан	negative		
наркокриминал	negative		
наркокурьер	negative		
наркокурьерша	negative		
наркоман	negative		
наркоманизация	negative		
наркомания	negative		
наркоманка	negative		
наркоопасность	negative		
наркоперевозчик	negative		
наркопоток	negative		
наркопотребитель	negative		
наркопотребление	negative		
наркопреступник	negative		
наркопритон	negative		
наркопроизводитель	negative		
наркорынок	negative		
наркосбытчик	negative		
наркосбытчица	negative		
наркосеть	negative		
наркосиндикат	negative		
наркосклад	negative		
наркосообщество	negative		
наркосырье	negative		
наркота	negative		
наркотизм	negative		
наркотик	negative		
наркотоксикомания	negative		
наркоторговец	negative		
наркоторговка	negative		
наркоточка	negative		
наркотранзит	negative		
наркоэпидемия	negative		
нарушение	negative		
нарушитель	negative		
нарушительница	negative		
нарциссизм	negative		
насилье	negative		
насильник	negative		
насильница	negative		
насмешник	negative		
насмешница	negative		
натянутость	negative		
наущение	negative		
нафиг	negative		
нафига	negative		
нахал	negative		
нахалка	negative		
нахальство	negative		
нахлобучка	negative		
нахрена	negative		
нахуй	negative		
нахуя	negative		
нацизм	negative		
националистка	negative		
национал-экстремизм	negative		
нацистка	negative		
неадекватность	negative		
неаккуратность	negative		
неблаговидность	negative		
неблагодарность	negative		
неблагозвучность	negative		
неблагополучие	negative		
неблагопристойность	negative		
неблагоприятность	negative		
невежественность	negative		
невежество	negative		
невежливость	negative		
невзгода	negative		
невзрачность	negative		
невнимательность	negative		
невольничество	negative		
невоспитанность	negative		
невразумительность	negative		
невыгода	negative		
невыгодность	negative		
невыносимость	negative		
негативность	negative		
негодование	negative		
негодяй	negative		
негодяйка	negative		
неграмотность	negative		
негуманность	negative		
недальновидность	negative		
недисциплинированность	negative		
недоброжелатель	negative		
недоброжелательница	negative		
недоброжелательность	negative		
недобросовестность	negative		
недоразвитие	negative		
недоразвитость	negative		
недоразумение	negative		
недостойность	negative		
недотепа	negative		
недоумение	negative		
недоумок	negative		
недруг	negative		
недружелюбие	negative		
неинтересность	negative		
неискренность	negative		
неискусность	negative		
неисправность	negative		
некачественность	negative		
неквалифицированность	negative		
некорректность	negative		
некрасивость	negative		
некрофил	negative		
некрофилка	negative		
нелегалка	negative		
нелегальность	negative		
нелегитимность	negative		
нелепость	negative		
нелогичность	negative		
немилосердность	negative		
немилость	negative		
ненавистник	negative		
ненавистница	negative		
ненавистничество	negative		
ненависть	negative		
ненастье	negative		
неодобрение	negative		
неодобрительность	negative		
неонацист	negative		
неопрятность	negative		
неотесанность	negative		
неотзывчивость	negative		
неофашизм	negative		
неофашист	negative		
неперспективность	negative		
неполадки	negative		
непорядочность	negative		
непочтение	negative		
непочтительность	negative		
непригодность	negative		
неприкрытость	negative		
неприличие	negative		
неприличность	negative		
непристойность	negative		
неприязнь	negative		
неприятель	negative		
неприятность	negative		
непрофессионализм	negative		
нерадостность	negative		
неразборчивость	negative		
неразвитость	negative		
неразумность	negative		
нервотрепка	negative		
несправедливость	negative		
несчастливец	negative		
несчастливица	negative		
несчастливчик	negative		
несчастье	negative		
нетактичность	negative		
неуважение	negative		
неуважительность	negative		
неудача	negative		
неудачливость	negative		
неудачник	negative		
неудачница	negative		
неудачность	negative		
неудобность	negative		
неудобство	negative		
неудовлетворение	negative		
неудовлетворенность	negative		
неудовольствие	negative		
неумелость	negative		
неуспех	negative		
неуспешность	negative		
неутешность	negative		
неухоженность	negative		
неуч	negative		
нехуй	negative		
нецелесообразность	negative		
нецензурщина	negative		
нечестивость	negative		
нечестность	negative		
нечистоплотность	negative		
нещадность	negative		
неэтичность	negative		
неэффективность	negative		
ниггер	negative		
нигер	negative		
низкокачественность	negative		
низкопробность	negative		
низкосортность	negative		
никудышность	negative		
нифига	negative		
ничтожество	negative		
ничтожность	negative		
нудность	negative		
нытик	negative		
обворовывание	negative		
обдираловка	negative		
обида	negative		
обидность	negative		
обидчик	negative		
обидчица	negative		
обкрадывание	negative		
обманщик	negative		
обманщица	negative		
оборванец	negative		
оборванка	negative		
обструкция	negative		
обсчитывание	negative		
оглупление	negative		
огорчение	negative		
огорчительность	negative		
ограбление	negative		
одиозность	negative		
одурелость	negative		
одурение	negative		
одурь	negative		
ожесточенность	negative		
озверение	negative		
озлобление	negative		
озлобленность	negative		
оккупант	negative		
оккупирование	negative		
околесица	negative		
олух	negative		
омерзение	negative		
омерзительность	negative		
опаивание	negative		
оплевывание	negative		
оплеуха	negative		
оплошность	negative		
опошление	negative		
опошливание	negative		
опрометчивость	negative		
осечка	negative		
осквернение	negative		
осквернитель	negative		
осквернительница	negative		
оскорбитель	negative		
оскорбительница	negative		
оскорбительность	negative		
оскорбление	negative		
остолоп	negative		
осуждение	negative		
отвратительность	negative		
отвратность	negative		
отвращение	negative		
откат	negative		
отместка	negative		
отморозок	negative		
отмщение	negative		
отрава	negative		
отравление	negative		
отсталость	negative		
отстой	negative		
отупение	negative		
отцеубийство	negative		
отцеубийца	negative		
охаивание	negative		
ошибочность	negative		
пагубность	negative		
падло	negative		
пакость	negative		
паникер	negative		
паникерство	negative		
паникерша	negative		
пасквиль	negative		
пасквилянт	negative		
пасквилянтка	negative		
паяц	negative		
педераст	negative		
педерастия	negative		
педик	negative		
педофил	negative		
педофилия	negative		
пентюх	negative		
пердеж	negative		
перебранка	negative		
передряга	negative		
передряги	negative		
перепалка	negative		
переполох	negative		
переутомление	negative		
пидар	negative		
пидарас	negative		
пидор	negative		
пизда	negative		
пиздеж	negative		
пиздец	negative		
плагиат	negative		
плагиатор	negative		
плен	negative		
пленение	negative		
плут	negative		
плутовка	negative		
плутовство	negative		
побои	negative		
поборы	negative		
погибель	negative		
погрешность	negative		
погром	negative		
погубитель	negative		
подворовывание	negative		
поджигатель	negative		
поджигательница	negative		
подлец	negative		
подлиза	negative		
подложность	negative		
подлость	negative		
подлюга	negative		
подневольность	negative		
подонок	negative		
подстава	negative		
подстрекатель	negative		
подстрекательница	negative		
подстрекательство	negative		
подсуживание	negative		
подтасовка	negative		
подтасовывание	negative		
подхалим	negative		
подхалимаж	negative		
подхалимка	negative		
подхалимничанье	negative		
подхалимство	negative		
позер	negative		
позерка	negative		
позерство	negative		
позор	negative		
позорище	negative		
позорность	negative		
показуха	negative		
поклеп	negative		
политрепрессии	negative		
полицай	negative		
полудурок	negative		
полупьяный	negative		
помарка	negative		
поножовщина	negative		
попрек	negative		
попрошайничество	negative		
популизм	negative		
популист	negative		
популистка	negative		
попуститель	negative		
попустительница	negative		
попустительство	negative		
порабощение	negative		
порицание	negative		
порок	negative		
порочность	negative		
поругание	negative		
порча	negative		
постыдность	negative		
потаскуха	negative		
потворство	negative		
потворствование	negative		
потворщик	negative		
потворщица	negative		
потрава	negative		
потрахушка	negative		
похабность	negative		
похабщина	negative		
пошлость	negative		
пошлятина	negative		
правонарушительница	negative		
празднословие	negative		
прегрешение	negative		
предательница	negative		
предательство	negative		
предвзятость	negative		
предосудительность	negative		
препоны	negative		
преступница	negative		
преступность	negative		
претенциозность	negative		
придирка	negative		
придирчивость	negative		
придурок	negative		
придурь	negative		
принижение	negative		
принуждение	negative		
приспособленец	negative		
приспособленка	negative		
приспособленчество	negative		
приставучий	negative		
притвора	negative		
притворщик	negative		
притворщица	negative		
притеснение	negative		
притеснитель	negative		
прихвостень	negative		
прихлебатель	negative		
прихлебательница	negative		
пробоина	negative		
провальность	negative		
провокатор	negative		
провокаторша	negative		
провокационность	negative		
провокация	negative		
провоцирование	negative		
прогульщица	negative		
продажность	negative		
происки	negative		
пройдоха	negative		
проклятие	negative		
проклятье	negative		
пролаза	negative		
промах	negative		
промашка	negative		
пропойца	negative		
проступок	negative		
противоестественность	negative		
противозаконность	negative		
противоправность	negative		
противоречивость	negative		
противоречие	negative		
профан	negative		
профанация	negative		
прохвост	negative		
прохвостка	negative		
прохиндей	negative		
прохиндейка	negative		
проходимец	negative		
проходимка	negative		
прощелыга	negative		
психопат	negative		
пустобрех	negative		
пустоголовость	negative		
пустозвон	negative		
пустозвонство	negative		
пустомеля	negative		
пустослов	negative		
пустословие	negative		
пытка	negative		
пьяница	negative		
пьянчуга	negative		
пьянчужка	negative		
пьянь	negative		
рабство	negative		
разбойница	negative		
разболтанность	negative		
разброд	negative		
разваливание	negative		
развинченность	negative		
разврат	negative		
развратник	negative		
развратница	negative		
развращение	negative		
развязность	negative		
разгильдяй	negative		
разгильдяйка	negative		
разгильдяйство	negative		
разгневанность	negative		
разграбление	negative		
разгром	negative		
раздолбайство	negative		
раздор	negative		
раздражение	negative		
раздраженность	negative		
раздражитель	negative		
раздражительность	negative		
разлад	negative		
размолвка	negative		
разоритель	negative		
разорительница	negative		
разорительность	negative		
разочарование	negative		
разочарованность	negative		
разрозненность	negative		
разруха	negative		
разрушительница	negative		
разрушительность	negative		
расист	negative		
расистка	negative		
раскол	negative		
распутник	negative		
распутница	negative		
распутство	negative		
распущенность	negative		
расстраивание	negative		
расстрел	negative		
растление	negative		
расточитель	negative		
расточительница	negative		
расточительность	negative		
расточительство	negative		
растранжиривание	negative		
растратчик	negative		
растратчица	negative		
расхититель	negative		
расхищение	negative		
расчлененка	negative		
резня	negative		
репрессивность	negative		
рецидивизм	negative		
рецидивист	negative		
рецидивистка	negative		
ротозей	negative		
рохля	negative		
рукоприкладство	negative		
русофоб	negative		
русофобия	negative		
рэкетир	negative		
рэкетирша	negative		
садизм	negative		
садист	negative		
садистка	negative		
самовластность	negative		
самовлюбленность	negative		
самовольство	negative		
самодур	negative		
самодурка	negative		
самодурство	negative		
самолюбование	negative		
самообольщение	negative		
самоповешение	negative		
саморазрушение	negative		
самосожжение	negative		
самоубийца	negative		
самоунижение	negative		
самоуничижение	negative		
сатрап	negative		
свара	negative		
сварливость	negative		
свастика	negative		
свинство	negative		
своекорыстие	negative		
своекорыстность	negative		
сволочь	negative		
сглаз	negative		
себялюбец	negative		
себялюбие	negative		
себялюбка	negative		
секс-скандал	negative		
синяк	negative		
скабрезность	negative		
скандал	negative		
скандалист	negative		
скандалистка	negative		
скандальность	negative		
скандальчик	negative		
скаред	negative		
скареда	negative		
скаредник	negative		
скаредность	negative		
сквалыга	negative		
сквалыжник	negative		
сквалыжница	negative		
скинхед	negative		
скинхэд	negative		
склочничество	negative		
скопидом	negative		
скопидомка	negative		
скопидомничество	negative		
скопидомство	negative		
скорбь	negative		
скряга	negative		
скряжничество	negative		
скудоумие	negative		
скулеж	negative		
скупердяй	negative		
скупердяйка	negative		
скупердяйство	negative		
скупец	negative		
скупость	negative		
скученность	negative		
слабак	negative		
слабачка	negative		
слабоволие	negative		
слаборазвитость	negative		
слащавость	negative		
словоблудие	negative		
слюнтяй	negative		
слюнтяйка	negative		
слякоть	negative		
смертоубийство	negative		
смрад	negative		
смрадность	negative		
смутьян	negative		
совковость	negative		
совращение	negative		
согрешение	negative		
содомит	negative		
сопляк	negative		
соплячка	negative		
сорванец	negative		
спам-бот	negative		
спамер	negative		
спамовый	negative		
спекулирование	negative		
спекулянтка	negative		
спертость	negative		
спесь	negative		
сплетник	negative		
сплетница	negative		
срака	negative		
срыв	negative		
ссадина	negative		
стерва	negative		
стервец	negative		
стервоза	negative		
стереотипность	negative		
страдание	negative		
страхолюдина	negative		
страшилище	negative		
строптивость	negative		
стукач	negative		
стукачество	negative		
стукачка	negative		
стыд	negative		
стыдливость	negative		
стяжатель	negative		
стяжательница	negative		
стяжательство	negative		
суицид	negative		
сумасбродка	negative		
сумасбродничанье	negative		
сумасбродность	negative		
сумасбродство	negative		
сумасшествие	negative		
сумбур	negative		
сумбурность	negative		
супостат	negative		
сутолока	negative		
тарабарщина	negative		
твердолобость	negative		
телка	negative		
террор	negative		
терроризирование	negative		
террористка	negative		
тиран	negative		
тирания	negative		
тиранка	negative		
тиранство	negative		
титушка	negative		
тлен	negative		
токсикоз	negative		
токсичность	negative		
толстуха	negative		
толстяк	negative		
толчея	negative		
тоска	negative		
тоскливость	negative		
тоталитарность	negative		
тошнота	negative		
тошнотворность	negative		
травля	negative		
травматизм	negative		
трагедийность	negative		
трагизм	negative		
трагичность	negative		
транжир	negative		
транжира	negative		
транжирка	negative		
транжирство	negative		
траур	negative		
трафикинг	negative		
траффикинг	negative		
тревога	negative		
тревожность	negative		
трус	negative		
трусиха	negative		
трусливость	negative		
трусость	negative		
туберкулезник	negative		
туберкулезница	negative		
тугодум	negative		
тугодумие	negative		
тупица	negative		
тупость	negative		
тупоумие	negative		
туфта	negative		
тщедушие	negative		
тщедушность	negative		
тщеславие	negative		
тщеславность	negative		
тягомотина	negative		
убивец	negative		
убивица	negative		
убиение	negative		
убийца	negative		
ублюдок	negative		
убогость	negative		
убожество	negative		
убыль	negative		
увалень	negative		
увечье	negative		
угнетатель	negative		
угнетение	negative		
угнетенность	negative		
угодничество	negative		
уголовка	negative		
уголовник	negative		
уголовница	negative		
уголовщина	negative		
угонщик	negative		
угонщица	negative		
удавка	negative		
удушение	negative		
ужас	negative		
ужасность	negative		
узурпатор	negative		
узурпаторша	negative		
узурпация	negative		
узурпирование	negative		
укор	negative		
укоризна	negative		
укоризненность	negative		
ультранационалист	negative		
ультрарадикал	negative		
умервщление	negative		
унижение	negative		
униженность	negative		
унизительность	negative		
уничижение	negative		
уничтожение	negative		
упадок	negative		
упрек	negative		
упущение	negative		
упырь	negative		
урод	negative		
уродец	negative		
уродина	negative		
уродка	negative		
уродливость	negative		
уродование	negative		
уродство	negative		
утрата	negative		
ухудшение	negative		
ущемление	negative		
ущемленность	negative		
ущерб	negative		
ущербность	negative		
фабрикация	negative		
фальсификат	negative		
фальсификатор	negative		
фальсификаторша	negative		
фальсификация	negative		
фальсифицирование	negative		
фальшивка	negative		
фальшивомонетчик	negative		
фальшивомонетчица	negative		
фальшивость	negative		
фальшь	negative		
фанфарон	negative		
фанфаронка	negative		
фарисейство	negative		
фейл	negative		
фейспалм	negative		
фиаско	negative		
фиктивность	negative		
фикция	negative		
филон	negative		
филонка	negative		
фурия	negative		
халатность	negative		
халтура	negative		
хам	negative		
хамка	negative		
хамство	negative		
ханжество	negative		
хвастливость	negative		
хвастун	negative		
хвастунья	negative		
хвороба	negative		
хворость	negative		
хворь	negative		
хилость	negative		
хиляк	negative		
хилячка	negative		
ходульность	negative		
холодрыга	negative		
холокост	negative		
холоп	negative		
холопка	negative		
холуй	negative		
холуйство	negative		
хуета	negative		
хуй	negative		
хуйня	negative		
хуле	negative		
хулиган	negative		
хулиганка	negative		
хулиганство	negative		
хулиганье	negative		
цинизм	negative		
циник	negative		
циничность	negative		
чванливость	negative		
чванность	negative		
чванство	negative		
человеконенавистник	negative		
человекоубийство	negative		
чепуха	negative		
чепуховина	negative		
чинуша	negative		
членовредительство	negative		
чувиха	negative		
чудище	negative		
чудовище	negative		
чудовищность	negative		
чушь	negative		
шайка	negative		
шантаж	negative		
шантажирование	negative		
шантажист	negative		
шантажистка	negative		
шарага	negative		
шаромыга	negative		
шаромыжник	negative		
шельма	negative		
шельмец	negative		
шизик	negative		
шизоид	negative		
ширпотреб	negative		
шкода	negative		
шкодник	negative		
шкодница	negative		
шлюха	negative		
шлюшка	negative		
шовинизм	negative		
шовинист	negative		
шовинистка	negative		
штрафник	negative		
эгоизм	negative		
эгоист	negative		
эгоистичность	negative		
эгоистка	negative		
экстремизм	negative		
экстремист	negative		
экстремистка	negative		
энтомовредитель	negative		
эпатаж	negative		
эпатирование	negative		
этноцид	negative		
этночистка	negative		
юдофоб	negative		
юдофобия	negative		
юдофобка	negative		
ябеда	negative		
ябедник	negative		
ябедничанье	negative		
ябедничество	negative		
адекватность	positive		
аккуратист	positive		
аккуратистка	positive		
аккуратность	positive		
ангел	positive		
аппетитность	positive		
башковитость	positive		
бдительность	positive		
безвинность	positive		
безвредность	positive		
беззлобность	positive		
безобидность	positive		
безошибочность	positive		
безперебойность	positive		
безукоризненность	positive		
бережливость	positive		
бережность	positive		
бесконфликтность	positive		
бескорыстие	positive		
бескорыстность	positive		
бесподобность	positive		
беспорочность	positive		
бесценность	positive		
благовидность	positive		
благовоспитанность	positive		
благодарность	positive		
благожелательность	positive		
благозвучность	positive		
благополучие	positive		
благополучность	positive		
благопристойность	positive		
благоприятность	positive		
благоприятствование	positive		
благоразумие	positive		
благоразумность	positive		
благородность	positive		
благородство	positive		
благосклонность	positive		
благосостояние	positive		
благотворитель	positive		
благотворительница	positive		
благотворность	positive		
благочестивость	positive		
благочестие	positive		
бравость	positive		
вдумчивость	positive		
вежливость	positive		
великолепие	positive		
великолепность	positive		
величественность	positive		
величие	positive		
взаимоподдержка	positive		
взаимопомощь	positive		
взаимопонимание	positive		
взаимосотрудничество	positive		
виртуоз	positive		
виртуозка	positive		
виртуозность	positive		
вкуснятина	positive		
вкусняшка	positive		
влюбленность	positive		
внимательность	positive		
воодушевление	positive		
воспевание	positive		
воспитанность	positive		
восторг	positive		
восторженность	positive		
восхваление	positive		
восхитительность	positive		
восхищение	positive		
вразумительность	positive		
вундеркинд	positive		
выгода	positive		
выдержанность	positive		
выигрыш	positive		
выигрышность	positive		
галантность	positive		
гармонизация	positive		
гармоничность	positive		
гениальность	positive		
гений	positive		
героизм	positive		
героичность	positive		
геройство	positive		
глубокомысленность	positive		
гостеприимность	positive		
гостеприимство	positive		
грамотность	positive		
гуманизация	positive		
гуманность	positive		
дальновидность	positive		
дельность	positive		
диво	positive		
дисциплинированность	positive		
доблесть	positive		
добродетель	positive		
добродетельность	positive		
добродушие	positive		
доброжелатель	positive		
доброжелательница	positive		
доброжелательность	positive		
добропорядочность	positive		
добросердечие	positive		
добросердечность	positive		
добросовестность	positive		
добрососедство	positive		
доброта	positive		
добротность	positive		
добряк	positive		
добрячка	positive		
дока	positive		
друг	positive		
дружба	positive		
дружелюбие	positive		
дружелюбность	positive		
дружественность	positive		
душевность	positive		
единение	positive		
единство	positive		
желанность	positive		
живописность	positive		
жизнерадостность	positive		
заботливость	positive		
законопослушание	positive		
законопослушность	positive		
замечательность	positive		
защищенность	positive		
здравомыслие	positive		
знаток	positive		
зрелищность	positive		
идеал	positive		
излечение	positive		
излечивание	positive		
изобретательность	positive		
изощренность	positive		
изыск	positive		
изысканность	positive		
изящество	positive		
изящность	positive		
именитость	positive		
интеллектуал	positive		
интеллектуалка	positive		
интеллигент	positive		
интеллигентка	positive		
искренность	positive		
искусник	positive		
искусница	positive		
исполнительность	positive		
исправность	positive		
исцеление	positive		
кайф	positive		
кайфовый	positive		
камбэк	positive		
качественность	positive		
клас	positive		
коммуникативность	positive		
комплимент	positive		
комфорт	positive		
комфортабельность	positive		
комфортность	positive		
конструктивность	positive		
краса	positive		
красава	positive		
красавец	positive		
красавица	positive		
красавчик	positive		
красивость	positive		
красота	positive		
красотища	positive		
красотка	positive		
кротость	positive		
круть	positive		
кумир	positive		
кунак	positive		
лакомка	positive		
лакомство	positive		
лапочка	positive		
лапушка	positive		
ласковость	positive		
легальность	positive		
легендарность	positive		
легитимность	positive		
ликование	positive		
логичность	positive		
любезность	positive		
мамуля	positive		
мастак	positive		
мастерица	positive		
мастерство	positive		
маститость	positive		
мелодичность	positive		
меценат	positive		
меценатка	positive		
меценатство	positive		
милаха	positive		
милаша	positive		
милашка	positive		
милосердие	positive		
милосердность	positive		
милость	positive		
миролюбивость	positive		
миролюбие	positive		
многогранность	positive		
многосторонность	positive		
молодец	positive		
молодчина	positive		
моральность	positive		
мудрец	positive		
мужественность	positive		
мужество	positive		
наблюдательность	positive		
надежность	positive		
наслаждение	positive		
находчивость	positive		
начитанность	positive		
незаурядность	positive		
неоценимость	positive		
непогрешимость	positive		
неподражаемость	positive		
непорочность	positive		
непревзойденность	positive		
непредвзятость	positive		
несравненность	positive		
нетленка	positive		
ништяк	positive		
няша	positive		
няшка	positive		
няшность	positive		
обаяние	positive		
обаятельность	positive		
обворожительность	positive		
облегчение	positive		
ободрение	positive		
образцовость	positive		
обходительность	positive		
одаренность	positive		
одобрение	positive		
одобрительность	positive		
оздоровление	positive		
окрыление	positive		
опрятность	positive		
оптимальность	positive		
оптимизация	positive		
оптимум	positive		
организованность	positive		
органичность	positive		
оригинальность	positive		
освободитель	positive		
освободительница	positive		
отвага	positive		
отважность	positive		
отзывчивость	positive		
отменность	positive		
отрада	positive		
очарование	positive		
очаровательность	positive		
очаровашка	positive		
первоклассность	positive		
первостатейность	positive		
перспективность	positive		
пиетет	positive		
пикантность	positive		
плодотворность	positive		
победа	positive		
победитель	positive		
победоносность	positive		
подвиг	positive		
подвижник	positive		
подвижница	positive		
подвижничество	positive		
подмога	positive		
полезность	positive		
польза	positive		
поразительность	positive		
породистость	positive		
порядочность	positive		
похвала	positive		
похваливание	positive		
похвальность	positive		
почет	positive		
почетность	positive		
почтение	positive		
почтенность	positive		
почтительность	positive		
правдивость	positive		
правдоподобность	positive		
праздник	positive		
превосходность	positive		
превосходство	positive		
преимущественность	positive		
прекрасность	positive		
престиж	positive		
престижность	positive		
преуспеяние	positive		
приветливость	positive		
привлекательность	positive		
пригодность	positive		
признательность	positive		
приличие	positive		
приличность	positive		
пристойность	positive		
притягательность	positive		
приязнь	positive		
приятель	positive		
приятность	positive		
прогрессивность	positive		
продвинутость	positive		
прок	positive		
проникновенность	positive		
проницательность	positive		
просветленность	positive		
простор	positive		
просторность	positive		
профессионализм	positive		
профессионалка	positive		
профессиональность	positive		
процветание	positive		
пупсик	positive		
работоспособность	positive		
радостность	positive		
радость	positive		
радужность	positive		
радушие	positive		
разборчивость	positive		
развитость	positive		
разумность	positive		
результативность	positive		
респектабельность	positive		
самообладание	positive		
самоотверженность	positive		
самосовершенствование	positive		
самоуважение	positive		
самоусовершенствование	positive		
свободность	positive		
сексапильность	positive		
секси	positive		
сердечность	positive		
симпатичность	positive		
симпатия	positive		
симпатяга	positive		
скидочка	positive		
сладостность	positive		
слаженность	positive		
смекалистость	positive		
смекалка	positive		
сметливость	positive		
смышленость	positive		
сногсшибательность	positive		
сноровистость	positive		
соблазнительность	positive		
совершенствование	positive		
совестливость	positive		
совесть	positive		
сокровище	positive		
сообразительность	positive		
сопереживание	positive		
сострадание	positive		
сочувствие	positive		
спасительность	positive		
сплоченность	positive		
справедливость	positive		
статность	positive		
стильность	positive		
стремительность	positive		
счастливец	positive		
счастливица	positive		
счастливчик	positive		
счастье	positive		
тактичность	positive		
талант	positive		
талантище	positive		
толковость	positive		
торжество	positive		
трезвомыслие	positive		
триумф	positive		
триумфатор	positive		
трогательность	positive		
трудолюбие	positive		
трудяга	positive		
тщание	positive		
уважение	positive		
уважительность	positive		
увлекательность	positive		
увлечение	positive		
увлеченность	positive		
удалец	positive		
удача	positive		
удачливость	positive		
удачник	positive		
удачница	positive		
удачность	positive		
удобность	positive		
удобство	positive		
удовлетворение	positive		
удовлетворенность	positive		
удовольствие	positive		
улучшение	positive		
улыбчивость	positive		
умелец	positive		
умелица	positive		
умелость	positive		
умница	positive		
умничка	positive		
уникальность	positive		
усердие	positive		
усердность	positive		
услада	positive		
успех	positive		
успешность	positive		
ухоженность	positive		
участливость	positive		
уют	positive		
уютность	positive		
феноменальность	positive		
филигранность	positive		
фурор	positive		
харизма	positive		
хвала	positive		
хваление	positive		
хитроумность	positive		
хлебосольство	positive		
храбрец	positive		
храбрость	positive		
целебность	positive		
целесообразность	positive		
целительность	positive		
человеколюбие	positive		
человечность	positive		
честность	positive		
честь	positive		
чистоплотность	positive		
чистосердечие	positive		
чистосердечность	positive		
чувственность	positive		
чудеса	positive		
чудесность	positive		
чудо	positive		
чудодейственность	positive		
шедевр	positive		
шик	positive		
шикарность	positive		
щедрость	positive		
щедрота	positive		
эйфория	positive		
элегантность	positive		
энтузиазм	positive		
энтузиаст	positive		
энтузиастка	positive		
эпичность	positive		
эстетичность	positive		
эталон	positive		
этичность	positive		
эффективность	positive		
эффектность	positive		
ювелирность	positive		
